#########
#.......#
#.P.C...#
#.......#
#...G...#
#.......#
#########
