############
#..........#
#.P..C.....#
#..###..C..#
#....#.....#
#..G..#..C.#
#....G...G.#
#..........#
############
