##########
#........#
#.P..C...#
#..###...#
#..#..C..#
#..G..G..#
#........#
##########
