##############
#............#
#.P.C..C.....#
#..##..##....#
#....C...C...#
#..G..G..G...#
#.....#..G...#
#............#
##############
