##########
#........#
#.P.C..G.#
#..##....#
#..C..G..#
#........#
##########
