########
#......#
#.P.CG.#
#......#
########
