##############
#............#
#.P.C..C..C..#
#..##..##....#
#....C...C...#
#..G..G..G...#
#....G...G...#
#............#
##############
