#############
#...........#
#.P..C......#
#..###.###..#
#....C...C..#
#..G...G.G..#
#...........#
#############
